WWWWWWWWWWWWWWWWWWWWWWWWWWWWWWWWWWWWWWWWWWWWWWWWWWWWWWWWWWWWWWWWWWWWWWWWWWWWWWWWWWWWWWWWWWWWWWWWWWWWWWWWWWWWWWWWWWWWWWWWWWWWWWWWWWWWWWWWWWWWWWWWWWWWWW
W----------------------------------------------------------------------------------------------------------------------------------------------------W
W------------------------------------------------------------------------------------w---------------------------------------------------------------W
W-------------------w----------------------------------w-------------------w-------------------------------------------------------------------------W
W--------------------------------------w---------------------------------------kk--------------------------------------------------------------------W
W-----------------------------------------------------------------------------k--k----k----k---------------------------------------------------------W
W----------------------c------------------------------------------------------k------kkk--kkk--w-----------------------------------------------------W
W--------------------------------E--------------------------------------r-----k-------k----k---------------------------------------------------------W
W----------------------------GGGGGGG-----------------------------------rr-----k--k-------------------------------------------------------------------W
W----------------------E----------------------------------------------rrr------kk--------------------------------------------------------------------W
W---------------c----GGGGG-------------------------------------------rrrr----------------------------------------------------------------------------W
W--------------------------------------tW---------------------------rrrrr----------------------------------------------------------------------------W
WG-------------------------------------WW--------------tW----------rrrrrr------------G---------------------------------------------------------------W
W------P----d----g-------d-------------WW--------------WW---------rrrrrrr-------------------F--------------------------------------------------------W
GGGGGGGGGGGGGGGGGGGGGGGGGGGGGGGGGGGGGGGGGGGGGGGGGGGGGGGGGGGGGGGGGGGGGGGGGGGGGGGGGGGGGGGGGGGGGGGGGGGGGGGGGGGGGGGGGGGGGGGGGGGGGGGGGGGGGGGGGGGGGGGGGGGGGG
GGGGGGGGGGGGGGGGGGGGGGGGGGGGGGGGGGGGGGGGGGGGGGGGGGGGGGGGGGGGGGGGGGGGGGGGGGGGGGGGGGGGGGGGGGGGGGGGGGGGGGGGGGGGGGGGGGGGGGGGGGGGGGGGGGGGGGGGGGGGGGGGGGGGGG
GGGGGGGGGGGGGGGGGGGGGGGGGGGGGGGGGGGGGGGGGGGGGGGGGGGGGGGGGGGGGGGGGGGGGGGGGGGGGGGGGGGGGGGGGGGGGGGGGGGGGGGGGGGGGGGGGGGGGGGGGGGGGGGGGGGGGGGGGGGGGGGGGGGGGG